0	0	0	8	9	7	0	4	1	2	0	0	0	0	0	0
0	0	3	0	0	0	0	2	1	2	3	6	0	0	0	0
9	1	0	0	3	5	0	4	0	5	0	0	6	7	2	1
2	0	0	1	2	1	0	6	0	1	5	0	0	0	1       0
1	2	0	0	1	0	0	0	0	1	0	0	0	0	0	4
0	0	0	6	4	1	4	6	0	0	0	0	1	2	0       1
2	0	0	9	5	9	0	7	1	0	0	0	1	8	9	1
7	2	0	7	8	4	0	5	0	0	1	1	0	1	10	1
0	1	0	9	0	0	0	1	0	0	1	0	0	7	8	1
0	0	5	4	0	8	7	9	0	0	0	1	5	6	0	1
0	3	4	8	7	0	10	0	0	0	1	0	0	1	9	1
0	1	6	0	0	0	0	10	0	0	0	0	0	0	4	10
0	5	0	7	0	0	7	0	0	1	0	0	0	0	0	10
3	1	0	8	8	0	4	6	6	5	0	2	0	2	2	1
2	0	0	3	3	5	0	8	9	2	0	0	2	2	2	0
