2	4	7	2	8	2	5	2	6	2	4	2	2	6	2	2
0	0	0	0	0	0	0	0	0	0	0	0	0	0	0	0
2	3	0	2	0	2	2	2	2	2	2	2	0	2	2	0
0	3	0	3	0	3	2	4	3	7	2	2	2	2	3	0
0	2	0	3	0	2	2	2	8	0	8	2	2	2	7	0
0	2	0	2	0	3	3	3	3	6	0	5	5	0	7	0
3	3	0	0	0	0	0	0	2	2	5	3	3	0	2	0
3	3	3	0	2	0	2	0	3	3	9	2	3	0	2	0
0	0	0	0	2	0	2	0	9	9	10	6	3	3	7	0
2	3	2	2	3	0	6	0	3	5	2	2	2	10	3	0
2	2	2	2	10	0	2	0	3	3	3	3	3	3	7	0
2	10	9	3	3	0	6	0	0	0	0	0	0	0	0	0
2	2	2	5	8	0	2	3	2	2	2	3	2	2	3	3
2	3	2	3	2	0	6	3	2	2	3	2	2	2	3	3
0	0	0	0	0	0	2	3	3	3	3	3	2	3	3	3


